10 10
1111111111
0000000011
1011101111
1000100011
1011101011
1000101011
1011111011
0000001011
1111111111
1111111111
