15 15
111111111111111
000000000000001
101111111110111
100010100000001
111010111010111
100010001010001
101010111011111
101000101010001
101111101011101
100000100000001
101011101010111
101010001010001
001111101010111
101000001010001
111111111111111
