35 35
11111111111111111111111111111111111
00000000100000000000100010000000001
10101110111110111011101110111111111
10100010100000001010100000000000001
10111010101110111110101111111010111
10001010000010100010001000000010001
10101110111111111011101110101010101
10101010001000101000000010101010101
10111010101110101110111011111110101
10100000100000101000001000100010101
11111011111010101010101110101111101
10000000001010001010101010001000001
11101011101011111011101010101110101
10101010101000000000100010100010101
10101010101110111011111011111110101
10001010100010100000001000001000101
10101110101110111111111111101110111
10101010000010000000000000100010001
10111010101010101010111111101011111
10100000101010101010001000001010001
10111010101111101011111011111010101
10101010100000101010001000100010101
11101011101011111111101010101011101
10001000101000000010000010101010001
11101110111010101111101010101010111
10000000001010101000001010101000101
10101011101011111110111011101010101
10101010001010000010100010101010001
11111010111010111011101010101110101
10000010001000001000101000100010101
10101111111010111110111111111110101
10101000000010100010001000001000101
00101010111011101111101110111110111
10101010001000000000100000000010001
11111111111111111111111111111111111
